R 640 480

NO ./textures/north.xpm
SO ./textures/south.xpm
WE ./textures/west.xpm
EA ./textures/east.xpm
S ./textures/greenlight.xpm

C 255,255,255
F 0,0,0

        1111111111111111111111111
        1000000000110000000000001
        1011000001110000002000001
        1001000000000000002000001
111111111011000001110000000000001
100000000011000001110111111111111
11110111111111011100000010201
11110111111111011101010010001
11000000110101011120202000201
10002000000000001100000010001
10000000000000001101010010201
1100000111010101111101111000111
11110111 1110101 101111010N01
11111111 1111111 111111111111
